12 12 12 12 12 12 12 12 12 12 12 12 12 12 12 12 12 12 12 12 12 12 12 12 12 12 12 12 12 12 12 12 12 12 12 12 12
12 12 12 12 12 12 12 12 12 12 12 12 12 12 12 12 12 12 12 12 12 12 12 12 12 12 12 12 12 12 12 12 12 12 12 12 12
12 12 12 12 12 12 12 12 12 12 12 12 12 12 12 12 12 12 12 12 12 12 12 12 12 12 12 12 12 12 12 12 12 12 12 12 12
12 12 12 24 11 11 11 11 11 11 11 11 11 11 11 11 11 11 11 11 11 11 11 11 11 11 11 11 11 11 11 11 11 25 12 12 12
12 12 12 21 10 10 10 10 10 10 10 10 10 10 10 10 10 10 10 10 10 10 10 10 10 10 10 10 10 10 10 10 10 20 12 12 12
12 12 12 21 10 15 15 15 15 15 15 15 10 10 13 13 13 13 13 10 10 10 10 10 10 10 10 13 13 13 13 10 10 20 12 12 12
12 12 12 21 10 15 16 16 16 16 16 15 10 10 10 10 10 10 10 10 10 10 10 10 10 10 10 10 10 10 10 10 10 20 12 12 12
12 12 12 21 10 15 16 16 16 16 16 15 10 10 13 13 13 13 13 10 10 10 10 10 10 10 10 13 13 13 13 10 10 20 12 12 12
12 12 12 21 10 15 16 16 16 16 16 15 10 10 10 10 10 10 10 10 10 10 10 10 10 10 10 10 10 10 10 10 10 20 12 12 12
12 12 12 21 10 15 15 15 10 15 15 15 10 10 13 13 13 13 13 10 10 10 10 10 10 10 10 13 13 13 13 10 10 20 12 12 12
12 12 12 21 10 10 10 10 10 10 10 10 10 10 10 10 10 10 10 10 10 10 10 10 10 10 10 10 10 10 10 10 10 20 12 12 12
12 12 12 21 10 10 10 10 10 10 10 10 10 10 13 13 13 13 13 14 14 13 13 13 13 13 13 13 13 13 13 10 10 20 12 12 12 
12 12 12 26 18 18 18 18 18 18 18 18 18 18 18 18 18 18 18 14 14 18 18 18 18 18 18 18 18 18 18 18 18 27 12 12 12
12 12 12 24 11 11 11 11 11 11 11 11 11 11 11 11 11 11 11 14 14 11 11 11 11 11 11 11 11 11 11 11 11 25 12 12 12
12 12 12 21 10 10 10 10 10 10 10 10 10 10 10 10 10 10 10 14 14 10 10 10 10 10 10 10 10 10 10 10 10 20 12 12 12
12 12 12 21 10 13 13 13 13 13 13 13 13 10 10 13 13 13 10 10 10 10 10 10 10 10 10 10 10 10 10 10 10 20 12 12 12
12 12 12 21 10 13 13 13 13 13 13 13 13 10 10 13 13 13 10 10 10 10 10 10 10 15 15 15 10 15 15 15 10 20 12 12 12
12 12 12 21 10 10 10 10 10 10 10 10 10 10 10 10 10 10 10 10 10 10 10 10 10 15 16 16 16 16 16 15 10 20 12 12 12
12 12 12 21 10 10 10 10 10 10 10 10 10 10 10 10 10 10 10 10 10 10 10 10 10 15 16 16 16 16 16 15 10 20 12 12 12
12 12 12 21 10 13 13 13 13 13 13 13 13 10 10 13 13 13 10 10 10 10 10 10 10 15 16 16 16 16 16 15 10 20 12 12 12
12 12 12 21 10 13 13 13 13 13 13 13 13 10 10 13 13 13 10 10 10 10 10 10 10 15 15 15 15 15 15 15 10 20 12 12 12
12 12 12 21 10 10 10 10 10 10 10 10 10 10 10 10 10 10 10 10 10 10 10 10 10 10 10 10 10 10 10 10 10 20 12 12 12
12 12 12 21 10 10 10 10 10 10 10 10 10 10 10 10 10 10 10 10 10 10 10 10 10 10 10 10 10 10 10 10 10 20 12 12 12
12 12 12 21 10 13 13 13 13 13 13 13 13 10 10 13 13 13 10 10 10 10 10 10 10 10 10 10 10 10 10 10 10 20 12 12 12
12 12 12 21 10 13 13 13 13 13 13 13 13 10 10 13 13 13 10 10 10 10 10 10 10 10 10 10 10 10 10 10 10 20 12 12 12
12 12 12 21 10 10 10 10 10 10 10 10 10 10 10 10 10 10 10 10 10 10 10 10 10 10 10 10 10 10 10 10 10 20 12 12 12
12 12 12 26 18 18 18 18 18 18 18 18 18 18 18 18 18 18 18 18 18 18 18 18 18 18 18 18 18 18 18 18 18 27 12 12 12
12 12 12 12 12 12 12 12 12 12 12 12 12 12 12 12 12 12 12 12 12 12 12 12 12 12 12 12 12 12 12 12 12 12 12 12 12
12 12 12 12 12 12 12 12 12 12 12 12 12 12 12 12 12 12 12 12 12 12 12 12 12 12 12 12 12 12 12 12 12 12 12 12 12
12 12 12 12 12 12 12 12 12 12 12 12 12 12 12 12 12 12 12 12 12 12 12 12 12 12 12 12 12 12 12 12 12 12 12 12 12